######################################
#           $            #           #
# ############### ##### ##     ##### #
#         #             #  ###       #
# ######            ###       ###    #
#        #          ######        #  #
# ######### ####### #      ###### ## #
#                               #  # #
#### #########################     # ]
#    #               D###      #   # #
# ########  ##### ########## #####   #
#                 #                  #
######################################